NO ./textures/wall_north.png
SO ./textures/wall_south.png
WE ./textures/wall_west.png
EA ./textures/wall_west.png

C 225,30,0
F 220,d100,0

111111111111111
100000000000001
101100000000001
100000000000001
111111111111111
