

    NO /mnt/homes/bchafi/Desktop/Cub3D_BCHAFI/mycuab3d/map/textures/satorupng 2.png    
        SO    /mnt/homes/bchafi/Desktop/Cub3D_BCHAFI/mycuab3d/map/textures/satorupng 3.png  
    WE    /mnt/homes/bchafi/Desktop/Cub3D_BCHAFI/mycuab3d/map/textures/satorupng 4.png   
  EA /mnt/homes/bchafi/Desktop/Cub3D_BCHAFI/mycuab3d/map/textures/satorupng.png
   
    F 222  ,     22   ,22
    C 22   ,  33,  3    

111111111111111

101100000000001
100000000000001
111111111111111