NO ./Textures/NO.xpm
SO ./Textures/SO.xpm
WE ./Textures/WS.xpm
EA ./Textures/EA.xpm

F 40,212,40
C 212,186,255

        11111111111111111
        10000000000000001
        10000000000000001
        10011111111110001
        1001        10001
111111111001        1000111111111
100000000001        1000000000001
100100000001111111111000000010001
10010000000000000000000000010001
100100000011111111111000000010001
11111111101         1011111111111
        101         101
        101111111111101
        100000000000001
        1S0000000000001
        100000000000001
        111111111111111