NO ./Textures/NO.xpm
SO ./Textures/SO.xpm
WE ./Textures/WS.xpm
EA ./Textures/EA.xpm

F 40,212,40
C 212,186,255

        111111111111111111111111111111111111111111111
        100000000000000000000000000000000000000000001
        100000000000000000000000000000000000000000001
        100111111111100000000000000000000000000000001
        1001        100000000000000000000000000000001
111111111001        10000000000000000000000000000000111111111
100000000001        10000000000000000000000000000000000000001
1001000000011111111110000000000000000000000000000000000010001
100100000000000000000000000000000000000000000000000000010001
1001000000111111111110000000000000000000000000000000000010001
11111111101         10000000000000000000000000000011111111111
        101         1000000000000000000000000000001
        1011111111111000000000000000000000000000001
        1000000000000000000000000000000000000000001
        1S00000000000000000000000000000000000000001
        1000000000000000000000000000000000000000001
        1111111111111111111111111111111111111111111