NO /home/bkali/Desktop/Cub3D_BCHAFI/textures/satorupng.png
SO /home/bkali/Desktop/Cub3D_BCHAFI/textures/satorupng.png
WE /home/bkali/Desktop/Cub3D_BCHAFI/textures/satorupng.png
EA /home/bkali/Desktop/Cub3D_BCHAFI/textures/satorupng.png


F  254, 121, 104
C 244, 239, 239

  111111111
 111000011111
101110111111
 10100E111111
 100000011111
1111111111111111