NO /mnt/homes/bchafi/Desktop/Cub3D_BCHAFI/map/textures/satorupng.png    
SO /mnt/homes/bchafi/Desktop/Cub3D_BCHAFI/map/textures/satorupng.png 
WE /mnt/homes/bchafi/Desktop/Cub3D_BCHAFI/map/textures/satorupng.png  
EA /mnt/homes/bchafi/Desktop/Cub3D_BCHAFI/map/textures/satorupng.png

F 255,255,255
C 20,33,3

  111111111
11100001
10N0011
1 0000011
 10000001
11111111