NO /mnt/homes/bchafi/Desktop/Cub3D_BCHAFI/map/textures/satorupng.png    
SO /mnt/homes/bchafi/Desktop/Cub3D_BCHAFI/map/textures/satorupng.png 
WE /mnt/homes/bchafi/Desktop/Cub3D_BCHAFI/map/textures/satorupng.png  
EA /mnt/homes/bchafi/Desktop/Cub3D_BCHAFI/map/textures/satorupng.png

F 255,255,255
C 20,33,3

111111
100001
10N001

111111