NO ./Textures/NO.xpm
SO ./Textures/SO.xpm
WE ./Textures/WS.xpm
EA ./Textures/EA.xpm

F 40,212,40
C 212,186,255

11111      111111
10001      100001
100001111110000011111
10000011100000000001 11111
100000000011001100001  11
10000000010000000111 11111
100000000000000001
11111111111111000111111111111
            100100000000000001
            100100000000000001
            100100000000000001
        11111000111111111111111111
            11100111000100001100111
               111000001111110001001
                 10011110000W000111011
                 100000000000000000001
                 1000011110000000000001
                 111111111111111111111

