NO ./Textures/NO.xpm
SO ./Textures/SO.xpm
WE ./Textures/WS.xpm
EA ./Textures/EA.xpm

F 220,100,0
C 225,30,0

1111111111111111111111111
1000000000000000000000001
1011111111111111111111101
1010000000000000000000101
1010111111111111111110101
1010100000000000000010101
1010101111111111101010101
1010101000000000101010101
1010101011111010101010101
1010101010010101010101W01
1010101010001010101010101
1010101011111010101010101
1010101000000000101010101
1010101111111111101010101
1010100000000000000010101
1010111111111111111110101
1010000000000000000000101
1011111111111111111111101
1000000000000000000000001
1111111111111111111111111